NO ./textures/NO.xpm
SO ./textures/SO.xpm
WE ./textures/WE.xpm
EA ./textures/EA.xpm
F 220,100,0
C 225,30,0

111111111111111111111111111111
100000000000000000000000000001
100000000000000000000000000001
100000000000000000000000000001
100000000000000000000000000001
100000000000000000000000000001
100000000000000000000000000001
100000000000000000000000000001
100000000000000000000000000001
100000011111111111110000000001
100000000000000000000000000001
100000000000000000000000000001
100000000000000010000000000001
100000000000000000000000000001
100000000000000000000000000001
100000000000000000000000000001
100000011111111110000000000001
100000000000011000000N00000001
100000000000010000000000000001
100000000111111111110000000001
100000000000000000000000000001
111111111111111111111111111111
