NO ./textures/NO.xpm
SO ./textures/SO.xpm
WE ./textures/WE.xpm
EA ./textures/EA.xpm
F 180,180,180
C 145,244,255

	1111111111111111111111111
	1000000000110000000000001	1111
	1011000001110000000000001	1001
	1001000000000000000000001	1111
111111111011000001110000000000001
100000000011000001110111111111111
11110111111111011100000010001	   1111
11110111111111011101010010001	   1001
11000000110101011100000010001	   1001
10000000000000001100000010001	   1111
10000000000000001101010010001	1111111111
11000001110101011111011110001	10000011011
11110111 11101N1 101111010001	10111010001
11111111 1111111 111111111111	111 1111111
