NO ./textures/Brick Walls/redbrick_32.xpm



SO ./textures/Brick Walls/redbrick_32.xpm
WE ./textures/Brick Walls/redbrick_32.xpm


F 180,180,180

EA ./textures/Brick Walls/redbrick_32.xpm








C 145,244,255

11111111111
10000000001
100000N0001
10000000001
11111111111
