NO ./textures/Brick Walls/redbrick_32.xpm
SO ./textures/Brick Walls/redbrick_32.xpm
WE ./textures/Brick Walls/redbrick_32.xpm
F 180,180,180
EA ./textures/Brick Walls/redbrick_32.xpm
C 145,244,255

11111111
10N00011
10000001
11111111
