NO ./textures/Brick Walls/brick_2k.xpm



SO ./textures/Brick Walls/brick_2k.xpm
WE ./textures/Brick Walls/brick_2k.xpm


F 180,180,180

EA ./textures/Brick Walls/brick_2k.xpm
DO ./textures/Doors/door_32.xpm




















C 145,244,255

	1111111111111111111111111
	1000000000110000000000001
	1011000001110000000000001
	1001000000000000000000001
111111111011000001111000000000001
100000000011000001100000111111111
11110111111111011100000010001
11000000110101000000000000001
10000000000000000000N00010001
10010010000000001100010010001
11000001110101011100011110001
11110111 1110101 101111010001
11111111 1111111 111111111111
