NO ./textures/Brick Walls/redbrick_32.xpm
SO ./textures/Brick Walls/redbrick_32.xpm
WE ./textures/Brick Walls/redbrick_32.xpm
F 180,180,180
EA ./textures/Brick Walls/redbrick_32.xpm
C 145,244,255
DO ./textures/Doors/door_32.xpm


1111111111111111111111111111
1000000000000000000000000001
1000000000000000000000000001
1000000000000001110000000001
1000000000000001910000000001
1000000000000001110000000001
1000000000000N00000000000001
1000000000000000000000000001
1000000000000000000000000001
1000000000000000000000000001
1111111111111111111111111111
