NO ./textures/Brick Walls/brick_64.xpm



SO ./textures/Brick Walls/mossy_64.xpm
WE ./textures/Brick Walls/gray_64.xpm


F 180,180,180

EA ./textures/Brick Walls/brown_64.xpm
DO ./textures/Doors/door_32.xpm




















C 145,244,255

1 1	111	1111111	11111	1111111	1111111111111
1 1	111	1111111	11111	1111111	1000000000001
1 1	111	1111111	11111	1111111	1000000000001
1 1	111	1111111	11111	1111111	1000019100001
1 1	111	1111111	11111	1111111	1000000000001
1 1	111	1111111	11111	1111111	1000000000101
1 1	111	1111111	11111	1111111	1000000N00901
1 1	111	1111111	11111	1111111	1000000000101
1 1	111	1111111	11111	1111111	1111111111111
